9 2 2 2 2 2 2 2 2 2 2 2 2 2 2 2 2 2 2 2 8
9 0 0 0 0 0 0 0 0 0 0 0 0 0 0 0 0 0 0 0 8
9 0 0 0 0 0 0 0 0 0 0 0 0 0 0 0 0 0 0 0 8
9 0 0 0 0 0 0 0 0 0 0 0 0 0 0 0 0 0 0 0 8
9 0 0 0 0 0 0 0 0 0 0 0 0 0 0 0 0 0 0 0 8
9 0 0 0 0 0 0 0 0 0 0 0 0 0 0 0 0 0 0 0 8
9 0 0 0 0 0 0 0 0 0 0 0 0 0 0 0 0 0 0 0 8
9 0 0 0 0 0 0 0 0 0 0 14 0 0 0 0 0 0 0 0 8
9 0 0 0 0 0 0 0 1 1 1 1 13 0 0 0 0 0 0 0 8
9 0 0 0 0 0 0 1 0 0 0 0 0 0 0 0 0 0 0 0 8
9 0 0 0 0 0 1 0 0 0 0 0 0 0 0 0 0 0 0 0 8
9 0 0 0 0 1 0 0 0 0 0 0 0 0 0 0 0 0 0 0 8
9 0 0 0 1 0 0 0 0 0 0 0 0 0 4 4 0 0 0 0 8
9 0 0 1 0 0 0 0 0 0 0 0 0 0 0 0 0 0 0 0 8
9 1 1 0 0 0 0 0 0 0 0 0 0 0 4 4 4 4 4 4 8
9 0 0 0 0 0 0 0 0 0 0 0 0 0 0 0 0 0 3 0 8
9 0 0 0 0 0 12 0 0 0 0 0 0 0 0 0 0 0 0 0 8
2 1 1 1 1 1 1 1 1 1 5 5 1 1 1 1 1 1 1 1 2