9 2 2 2 2 2 2 2 2 2 2 2 2 2 2 2 2 2 2 2 8
9 0 0 0 0 0 0 0 0 0 0 0 0 0 0 0 0 0 0 0 8
9 0 3 0 0 0 0 0 0 0 0 0 0 0 0 0 0 0 0 0 8
9 0 0 0 0 0 0 0 10 0 0 0 0 0 0 0 0 0 0 0 8
9 1 1 1 1 1 1 1 1 1 1 1 1 1 7 0 0 0 0 0 8
9 0 0 0 0 0 0 0 0 0 0 0 0 0 2 7 0 0 0 12 8
9 0 0 0 0 0 0 0 10 0 0 0 0 0 0 0 0 0 0 1 8
9 11 0 0 6 1 1 1 1 1 1 1 0 0 0 0 0 0 0 0 8
9 0 0 0 0 0 0 0 0 0 0 2 1 1 1 1 1 1 1 1 8
9 0 0 0 0 0 0 0 0 0 0 0 0 0 0 0 0 0 0 0 8
9 0 0 0 0 0 12 0 0 0 0 0 0 0 0 0 0 0 0 0 8
9 1 1 1 1 1 1 1 1 7 0 0 0 0 0 0 0 0 0 0 8
9 0 0 0 0 0 0 0 0 2 7 0 10 14 0 0 13 0 0 0 8
9 0 0 0 0 0 0 0 0 2 2 1 4 4 1 7 0 0 0 0 8
9 1 1 1 1 0 0 0 0 0 0 0 0 0 0 0 0 0 0 10 8
9 0 0 0 0 0 0 0 0 0 0 0 0 0 0 0 0 0 6 1 2
9 0 0 0 14 0 0 0 0 0 0 0 0 0 0 0 0 0 8 2 2
2 1 1 1 1 1 1 1 1 4 4 4 1 5 5 5 1 1 2 2 2