9 2 2 2 2 2 2 2 2 2 2 2 2 2 2 2 2 2 2 2 8
9 0 0 0 0 0 0 0 0 0 0 0 0 0 0 0 0 0 0 0 8
9 0 3 0 0 0 0 0 0 0 0 0 0 0 0 0 0 0 0 0 8
9 0 0 0 0 0 0 0 10 0 0 0 0 0 0 0 0 0 0 0 8
9 1 1 1 1 1 1 0 0 0 0 0 0 10 0 0 0 0 0 0 8
9 0 0 0 0 0 0 1 1 1 1 1 1 1 1 0 0 0 0 0 8
9 0 1 0 0 0 0 0 0 0 0 0 0 0 0 0 0 0 0 1 8
9 0 0 0 0 0 0 0 0 0 0 0 10 0 0 0 0 0 0 0 8
9 0 1 0 0 0 0 0 1 1 1 1 0 0 0 0 1 1 1 0 8
9 0 0 0 0 0 1 0 0 0 0 0 0 0 0 0 0 0 0 0 8
9 1 0 0 0 0 0 0 0 0 0 0 0 0 0 0 0 0 0 0 8
9 0 0 1 0 0 0 0 0 0 0 0 0 0 0 0 0 0 0 0 8
9 0 0 0 0 0 0 0 0 0 0 0 0 0 0 0 0 0 0 0 8
9 0 0 0 0 0 6 0 0 1 0 0 0 10 0 0 0 0 0 0 8
9 1 5 5 5 1 2 0 0 0 0 0 1 1 1 0 0 0 0 6 8
9 0 0 0 0 0 0 0 0 0 0 0 0 0 0 0 0 0 0 0 8
9 0 0 0 0 0 10 0 0 0 0 0 0 0 0 0 0 0 1 1 2
2 1 1 1 1 1 4 4 4 1 1 1 1 1 1 1 1 1 2 2 2