9 2 2 2 2 2 2 2 2 2 2 2 2 2 2 2 2 2 2 2 8
9 0 0 0 0 0 0 0 0 0 0 0 0 0 0 0 0 0 0 0 8
9 0 0 0 0 0 0 0 0 0 0 0 0 0 0 0 0 0 0 0 8
9 0 0 0 0 0 0 10 0 0 0 0 0 0 0 0 0 0 0 0 8
9 0 0 0 0 0 0 1 0 0 0 0 0 0 0 7 0 0 0 0 8
9 0 0 0 0 0 0 0 0 0 0 0 0 0 1 9 0 0 0 0 8
9 0 0 0 0 0 0 0 0 0 0 0 0 1 2 9 0 0 0 0 8
9 0 0 0 0 0 0 0 0 0 0 10 1 2 2 9 0 0 0 0 8
9 0 0 0 0 0 0 0 0 0 0 1 2 2 2 9 0 0 3 0 8
9 0 0 0 0 0 0 0 0 0 1 2 2 2 2 9 10 0 0 0 8
9 0 10 0 0 0 0 0 1 1 2 2 2 2 2 2 1 1 1 1 8
9 1 1 0 0 0 0 0 0 0 0 0 0 0 0 0 0 0 0 0 8
9 0 0 0 0 4 0 0 0 0 0 0 0 12 0 0 0 0 0 0 8
9 0 0 0 0 2 5 0 0 0 0 0 1 1 0 0 0 0 0 0 8
9 1 1 0 1 2 2 0 1 0 1 0 0 0 0 0 11 0 0 0 8
9 0 0 0 0 0 0 0 0 0 0 0 0 0 0 0 0 0 0 0 8
9 0 0 0 10 0 0 0 10 0 0 0 0 0 0 0 0 0 0 12 8
2 1 1 1 1 1 1 1 1 1 1 1 1 1 1 1 1 1 1 1 2